+-+-------+-----+
| |       |     |
| + ---   +  --++
|               |
+--  +-+    +---+
|    |      |   |
|  ---+--  +   -+
|           |   |
+-  -------+-- -+
|  +            |
|  +---- ----- -+
|               g
+---------------+